########################################
#S..................#.................G#
#.################22#.##################
#...................#.................#
#.################22#.##################
#...................#..................#
#.################..#.##################
#.....................................#
########################################
