####################
#S.....#..........#
#.#####.#.########.#
#.#.....#........#.#
#.#.############.#.#
#.#..............#.#
#.################.#
#..................#
#.##################
#.................G#
####################
