########################
#S.....#...............#
#.#####.#.##############
#.#.....#.#............#
#.#.#####.#.##########.#
#.#.....#.#......#...#.#
#.#####.#.######.#.#.#.#
#.....#.#........#.#.#.#
#####.#.############.#.#
#.....#............#.#.#
#.###############.#.#.#.#
#.................#...G#
########################
