############################
#S.....#~~~~~#............#
#.#####.#.###.#.#########.#
#.#.....#...#.#.#.......#.#
#.#.#########.#.#.#####.#.#
#.#.......~~~~#.#.#...#.#.#
#.#########.#####.#.#.#.#.#
#.....#.....#.....#.#.#.#.#
#####.#.#####.#####.#.#.#.#
#.....#.....#.....#.#.#.#.#
#.###############.#.#.#.#.#
#.................#...#..G#
############################
