##############################
#S.#.....#.#.......#........#
#.#.#.###.#.#.#####.#.######.#
#.#.#...#...#.#...#.#.#....#.#
#.#.###.#####.#.#.#.#.#.##.#.#
#.#.....#.....#.#.#.#.#..#.#.#
#.#####.#########.#.#.#.##.#.#
#.....#.....#.....#.#.#....#.#
#####.#####.#####.#.#.######.#
#.....#.....#.....#.#........#
#.###############.#.##########
#.................#.........G#
##############################
